#separator:tab
#html:false
在不换工作的情况下，如何用神（土金）为自己构建“防空洞”？	1  在不影响工作的前提下，对非核心且耗神的事务学会说“不”，可用“我现在有更优先的项目”或延长交付时间来保护精力。  2  无论多忙，最晚在子时（23点）准备睡觉，以早起（5–7点卯时）学习代替熬夜，将木气转为印。  3  每周至少进行3次力量训练（以举铁为佳），借助比劫迅速增强自身能量。
无论多忙，最晚在几点准备睡觉？以什么代替熬夜，从而将木气转为印？	最晚在子时（23点）准备睡觉，以早起（5–7点卯时）学习代替熬夜，从而将木气转为印。
每周至少进行3次什么训练，可以借助比劫迅速增强自身能量？	每周至少进行3次力量训练（以举铁为佳），可借助比劫迅速增强自身能量。
在工作上如何保护精力？	对非核心且耗神的事务学会说“不”，可用“我现在有更优先的项目”或延长交付时间来保护精力。
“比劫”帮身最直接、最快速的途径是什么？	每周至少进行3次力量训练（以健身房举铁为最佳）。
为什么早起（5–7点卯时）要用来学习？	因木旺，此时读书学习可将木气转化为印。
用什么来代替熬夜？	用早起（5–7点卯时）学习来代替熬夜，此时木旺，读书可将木转化为印。
为什么最晚子时（23点）必须准备入睡？	因子时为日主“死”地，且水旺，熬夜等于引水耗身。
健康上的“铁律守护”中，死命令是什么？	无论工作多忙，最晚子时（23点）必须准备入睡，杜绝任何借口。
在无法立刻改变外部“气候”、又必须保住工作的情况下，对非核心且耗神的事务应采取什么策略？	学会说“我现在手头有更优先的项目”或设定更长的交付时间。
无法立刻改变外部“气候”（流年）、无处可逃时，我们的策略应是什么？	在现有环境下立刻为自己构建一个用神（土金）的“防空洞”。
什么是我的第一优先级？	身体和能量。
为什么在今年“乙巳”不要跳槽？	因火旺流年下，新工作大概率延续甚至加剧火的属性——高压力、快节奏、强竞争，等于从一个火坑跳入更旺的火坑。
健康上的“铁律守护”具体指什么？	打破熬夜循环，设定最晚子时（23点）必须闭眼的死命令，以早起代替熬夜，从根本保护日主庚金不被火克。
工作上的“战略性敷衍”具体指什么？	在不丢工作的前提下，对非核心任务敢说“不”或适当拖延，把精力集中在最能积累专业资本（金）的关键任务上。
在职减压与蓄能要如何做到？需要采取哪两个行动来保护自己？	第一，工作上的“战略性敷衍”：在不丢工作的前提下，对非核心任务敢说“不”或适当拖延，将精力投入能积累专业资本（金）的关键任务。  第二，健康上的“铁律守护”：打破熬夜循环，设定最晚子时（23点）必须闭眼的死命令，以早起代替熬夜，保护日主庚金不被火克。
在工作压力巨大时，不应采用“离职避压”，而应采取什么策略？	应采取“在职减压与蓄能”，不是试图改变外部环境，而是立刻调整自己与环境的互动方式，在重压下为自己开辟内部的“保护空间”。
现在（2025年底）离职真的能避开压力吗？为什么？	不能。流年运势如同全年“气候”，换工作只换场所，气候不变。在乙巳火旺之年，匆忙找到的新工作大概率仍是高压、快节奏、强消耗的火性环境，甚至因仓促求职陷入更差处境。
一份压力小、节奏稳的工作，为您提供的“印星”核心价值是什么？	安全感、稳定感与休养生息的时间，这些都能直接滋养日主庚金。
“顺应命理”并非认命，而是教人“识时务”，是什么意思？	是在逆风时保存实力，顺风时全力进取。
在忌神肆虐、身弱不堪的运势里，“硬扛”是“坚强”吗？	“硬扛”不是坚强，往往反而是最大的消耗。
一个需要大量创意、沟通、出差的“轻松”工作，为什么可能反而在耗泄命主？	因为属水木属性，会持续耗泄您的能量。
命局、大运、流年的比喻分别是什么？	命局是先天体质，大运是十年气候，流年是具体天气。
七杀丙火为忌，遇事应避免正面硬刚，应该学会什么？	学会以柔（土）克刚（火），用成绩和资历（印）说话，而非情绪。
将资金转化为“印”或“比劫”分别指什么？	“印”指购房、投资教育、购买保值资产；“比劫”指升级生产力工具。
命主在专业技能上应该怎样做？	一是深耕 AI 算法领域，在一个细分方向做到极致； 二是将代码、论文与项目成果整理成作品集，成为您“金”的实体化身。
命主为什么需要争取考取权威的职业资格证书？	因为对您而言，证书象征着最强的“印”，能强化自身优势。
命主平时适合多吃什么食物？	脾胃属土，应规律三餐，少食生冷油腻。宜多吃根茎类和谷物，如山药、土豆、小米、黄豆。
命主适合多使用哪些颜色与材质？	颜色：黄色、棕色、咖啡色，以及白色、灰色、银色的衣物与装饰。  材质：陶瓷、玉石、石材制品。
比劫为用神意味着什么？	朋友即贵人。
什么可以成为命主“金”的实体化身？	将代码、论文、项目成果整理成作品集，即为您“金”的实体化身。
对于命主来说，最强的“金”是什么？	专业技能。
对于命主来说，最强的“印”是什么？	证书。
金（比劫）对命主具体指什么？	能直接增强日主力量，包括行动力、伙伴支持、专业技能与身体强度。
土（印）对命主具体指什么？	能直接生扶日主庚金，包括靠山、证书与健康。
“财多身弱”在命理上意味着什么？化解核心是什么？	意味着机会多但自身承载力不足，易感压力与消耗。化解核心在于补印、助比劫，即增强土（印）与金（比劫）。
新的 offer 若只是平级跳动或“压力换压力”，是否应跳槽？	不建议跳，宜持重等待。除非平台显著提升、职位契合长期规划，且薪资涨幅可观。
为什么要全力争取 2026 年 3 月的合同续约？	因丙午年份火势强、压力倍增，又逢换运前夕能量不稳，此次续约可为您争取宝贵的战略缓冲期。
若在 2026 年下半年已获优质 offer，应如何处理？	可商议 2027 年春季入职；若不同意则放弃，并在 2027 年开年后全力主攻，此阶段机遇质量最高。
跳槽与换平台的黄金窗口期是什么时候？为什么？	2027 年立春后至全年。此为官印相生之年，更易获得符合“稳定与发展”（印）需求的岗位，并遇到赏识您的领导。
为什么“金九银十”对您全年状态最有利？	因 2026 年 9–10 月（戊申、己酉月）金气当令，而命主属庚金，此时状态最佳。
在 2026 年 7 月后利用新运气场主动探索机会是顺应“亥水”食神的方向，但核心动作（签约入职）应在何时进行？	应瞄准 2027 年。
利用 2026 年 7 月后的新运气场积极接触机会、更新简历、参加面试，本质上顺应了什么？	顺应“亥水”食神探索新方向的趋势。
2026 年“金九银十”招聘季跳槽为何不利当年发展？	因若此时跳槽，等到 2027 年丁未年“官印相生”的黄金机遇出现时，您可能因入职未满一年难以再度变动，从而错过更佳平台。
为什么 2026 年下半年是新旧气场的过渡与博弈期？	因 7 月 7 日入乙亥大运，但流年仍为丙午，官杀旺势贯穿全年，换运后气场不会立即转变。
进入乙亥大运后是否可跳槽？为什么？	不适合。新运刚启、旧流年仍强，两者博弈不稳，2026 年下半年并非适合发力的节点。
命主的八字喜用神是金（比劫），在决策中应如何贯彻？	专注打磨硬核技能，并善用可靠人脉。
命主的八字喜用神是土（印），在决策中应如何贯彻？	选择稳健路线，偏向能积累资历、提升专业认证的方向。
命主八字的喜用神为土（印）与金（比劫）在决策中如何贯彻？	土（印）：选择稳健路线，重视资历积累与专业认证。  金（比劫）：强化硬核技能，并有效运用可靠人脉。
什么时候开始有策略地接触新职业机会？目标何时入职新岗位？	从 2026 年 8 月起开始有策略地接触新机会，目标在 2027 年（丁未年）入职新岗位。
寻找更稳定、发展平台更好的正印机遇的最佳时机？	黄金窗口在 2026 年第三季度换运后，尤其是 2027 年（丁未年）官印相生之时。
2026 年的整体时空背景如何从大运、流年与时间点分析？	大运：上半年仍在丙子运尾声，下半年进入乙亥运，交运阶段气场混沌。  流年：丙午年，丙火（七杀）与午火（正官）极旺，官杀混杂，对身弱庚金而言事业压力与外界挑战达顶峰。  时间点：3 月（甲辰月）处于丙午年火势最旺、又逢旧运尾声，此时贸然变动易陷被动并做出错误判断。
2026 年 3 月合约到期，为什么需要格外谨慎？	因旧运将尽、新运未至，又逢流年高压，呈三重夹击，需要慎之又慎。
2026 年 3 月合约到期时是否应主动离职寻找新机会？	宜暂时蛰伏，不宜跳槽；利用这段时间积极准备，等待换运后的最佳出击时机。
2026 年 3 月选择续约后，接下来的行动计划是什么？	于 2026 年 7 月换运后开始准备面试、接触猎头；待 2027 年丁未年官印相生，再谋求正式且稳定的好职位。
2026 年 3 月合约到期，应走还是留？稳妥策略是什么，为什么？	稳妥之策是“优先争取续约，即使作为短期过渡”。  这样可在 2026 上半年丙午火旺的高压期获得避风港，并争取宝贵缓冲时间。
在运势动荡期，首要原则不应是“追逐最大收益”，而应是什么？	应以“规避最大风险、保存实力”为先，这便是“用神”思维。
为什么半导体行业在五行上对命主有利？	因芯片以硅为主属土，制造过程高度精密属金，正契合命主所喜的土与金。
2026 年阳历 3 月为何事业压力达顶峰且易有变动？	因仍在丙子大运内，又处于丙午年年初；丙火七杀再现、午火为强七杀，“财生杀旺”之势对身弱庚金冲击极强，故压力与变动皆达高点。
大运交替之际为何气场混沌、不稳定？	如同季节转换，旧运丙子余势未散，新运乙亥之气已开始渗透，两股力量交叠而致气场混沌。
2026 年 7 月后（换运后）的主动探索期是否需要做重大决定？	此阶段以“探索、接触”为主，不急于做重大决定。
亥水作为食神代表什么？	代表新想法、移动与交流。
迷茫期的行动路线图：2026 年 7 月后（换运后）的主动探索期 ，行动有哪些？	行动：更新简历、接触猎头、参加行业会议，并开放接受相亲介绍。  此阶段重在“探索、接触”，不急于做重大决定。
迷茫期的行动路线图：当下至 2026 年 7 月（换运前）的金属性行动有哪些？	三项金（比劫）行动：  1. 打磨专业技能。  2. 在 GitHub 维护高质量项目。  3. 主动接触技术扎实的同行（比劫为用，可靠朋友即贵人）。
迷茫期的行动路线图：当下至 2026 年 7 月（换运前）的土属性行动有哪些？	四项土（印）行动：  1. 系统学习并考取与 AI 相关的权威认证。  2. 保持规律作息。  3. 坚持一项地面运动（如慢跑、健身）。  4. 整理北京的生活圈，断舍离无用社交。
迷茫期行动路线图：当下至 2026 年 7 月（换运前）的土与金属性行动有哪些？	土（印）：系统学习并考取 AI 相关认证；规律作息；坚持地面运动；整理生活圈并断舍离无用社交。  金（比劫）：打磨专业技能；在 GitHub 维护高质量项目；主动结识技术扎实的同行（比劫为用，可靠朋友即贵人）。
迷茫期行动路线图的三个阶段分别是什么？   当下至 2026 年 7 月，2026 年 7 月后 以及2027 年起	当下至 2026 年 7 月（换运前）：蛰伏积蓄期。  2026 年 7 月后（换运后）：主动探索期。  2027 年起：收获落地期。
命主换工作时应优先考虑什么平台？	优先选择稳定、具声誉的平台（印）。
换工作的最佳时机是什么时候？	建议在 2026 年进入乙亥大运后，再择机而动，优先考虑 2027 年（丁未）与 2028 年（戊申）。
自身能量最强的是哪一年？	2028年（戊申），因印比齐来，为您自身能量最强的一年。
大运转换以出生的几号为界吗？	不是，大运转换以节气为界。
感情或事业的新机遇会在什么时候出现？	自2026年下半年起逐渐显现，尤以2027–2028年最为明显。
为什么进入2026年的乙亥运后仍不建议换工作？	因乙亥运水木增强，但日主仍身弱，需土金流年助力。故建议等到2027年丁未（印星旺）或2028年戊申（比肩强根）再考虑变动。
哪一年缘分信号最强，大概率如何认识？	2027年丁未，丁火正官合日主，未土为正印又为财库，未亥半合化解子未穿，缘分信号非常强烈，且更可能通过工作环境或长辈介绍而相识。
命主在2026年何时准确换运？	2026年7月7日小暑节气。
命主的正缘何时能轻松出现？	通常在您身强、能够担财时，正缘才会轻松出现。
2025年双方的命局如何预示缘分难以健康维系？	女方为“夫星受冲”，您为“财杀攻身”，两者皆显示此缘在该运内难以稳定维持。
在乙亥运中，亥水为食神代表什么？	代表新的想法与迁移动向。
告别的最佳方式是什么？	不必刻意制造冲突，最佳方式是“自然冷却”与“事实更新”。
如何减弱这段关系在命理上的“财星耗身”效应？	停止一切“哀求式”沟通（伤官行为），专注自身，不再向对方投射能量。
停止一切“哀求”式沟通（伤官行为）将注意力收回后，可投入哪些能生助您“土金”的事物？	规律健身（金）、学习考证（印）、深耕AI算法（金）、经营北京朋友圈（比劫）。
命主为何大运逆排，大运逆排是什么意思？	因属阴年（乙亥）男命，大运采取逆排。  以出生日1995年3月10日为基准，逆数至上一个节气“惊蛰”（1995年3月6日）。
带着尊严和新希望离开这段消耗性关系的三步骤是什么？	第一步：在年底前停止主动联系，专注自身，为“印”的能量回归。  第二步：于2025年底或2026年初进行一次冷静告别，表达感谢但不指责不追问，展现“金”的干脆。  第三步：进入2026年后，尤其换运后，将重心转向事业、社交与自我提升，以迎接新大运。
命主在2026年具体何时换入乙亥运？	于阳历7月前后（以当年小暑、大暑节气的精确时间为准）正式进入乙亥大运。
计算命主开始大运时间的过程是什么？	从1995年3月10日逆数至上一个节气“惊蛰”（3月6日），共4天。以“三天一岁”推算，4天折合1年4个月。故自出生起约1年4个月（1996年7月左右）开始首步大运戊寅。
命主所说的“看淡了”如何理解为自我保护式觉醒？	因身弱最需补“土”（印星，代表自我关爱与内在力量）。当他不再将精力投向消耗他的“财”（女方）时，实则在潜意识中靠近自己的用神。
命主八字用神为土、忌神为水（伤官），这意味着什么？	土的特性是承载、稳健、信实。感情中应修炼“土”德：情绪稳定、规划务实、承诺笃定。  因忌神为水（伤官），需避免怀疑、反复与言语冲动。
一段稳定的婚姻对我来说属于什么？	属于“印”。
命主庚金身弱，最需要印星（土）的滋养在感情上指什么？	即安全感、归属感与实际支持。
她目前的“不积极回复”说明了什么？	多半是内心处于权衡、观望或迷茫的外在表现，并非全然无情。
2025年双方最大的挑战不在八字不合，而在于什么？	在于运势的同步冲击：此阶段至2026年，男方需承受现实压力，女方面临内心抉择。
二人夫妻宫子丑相合代表什么？	代表稳固的联结，具有走入婚姻的深厚缘分与内在默契，并非轻易散去的露水情缘。
男方和女方在2025年的情况分别是什么？	男方：处于丙子大运尾声，事业与金钱压力加大，情绪易烦躁，影响对感情的耐心与投入。  女方：思维更务实，婚姻需求提高，感情易出现动荡、竞争或重大抉择。
夫妻宫相合代表什么？	代表双方缘分深厚、默契强、彼此吸引力足，生活习惯也较易磨合。
双方八字中夫妻星未直接、有力地落在配偶宫意味着什么？	意味着彼此未必是对方的“第一眼”或“最理想化”类型。
命主日主为庚金、正财格，有哪两个缺陷？用神与喜神分别是什么？	缺陷：财旺身弱、七杀攻身。  用神为土，喜神为金。
事业上适合从事哪两种五行属性的行业？	适合从事五行属土（房地产、建筑、咨询、教育）或属金（金融、法律、机械、管理）的行业。
日坐伤官与丙火七杀贴身分别意味着什么？	日坐伤官：聪明机敏，但易思虑过度、敏感，言语偏直。  丙火七杀贴身：性格急躁刚强，行动果断。
夫妻宫坐子水伤官表示什么？	对感情有浪漫想象，但也容易挑剔。
什么样的婚恋对象对我最有利？	能提供情绪稳定、务实支持的伴侣（具印的特性）最有利。
命中财旺但身弱的形象化比喻是什么？	如同眼前有金山却无力搬运。
健康上需注意哪些身体部位？	需关注肺部、呼吸系统及肠道（金、土所主）。
事业方向是否适合创业或高风险投资？适合什么呢？	不宜独立创业或从事高风险投资，更适合在大型、稳定机构中以专业技能（印）稳步发展。  因时柱丙戌有杀印相生，中年后有望获得职权。
为什么命主的用神是土（印星）？	土能生扶日主庚金，使其有力承担旺财，又能化泄七杀丙火之气，形成“杀印相生”，为全局枢纽。
命主的用神、喜神与忌神分别是什么？	用神：土（印星）  喜神：金（比劫）  忌神：木（财星）、火（官杀）、水（食伤）
为什么会形成“财多身弱，杀旺攻身”的局面？	因庚金在卯月处胎地，木气正盛为正财当令；地支无强根（仅戌中辛金微根），又被旺木耗泄；同时时干丙火七杀攻身，故成财多身弱、杀旺攻身之势。
命主被财与杀两面夹击，这个命局的关键是什么？	关键在扶助日主，使庚金强起来，才能担起财官。
